"a" = (/turf/open/floor/rogue/naturalstone,/area/rogue)
"b" = (/turf/closed/wall/mineral/rogue/stonebrick,/area/rogue)
"c" = (/obj/structure/table/church/m,/turf/open/floor/rogue/churchmarble,/area/rogue)
"d" = (/obj/structure/mineral_door/wood,/turf/open/floor/rogue/blocks,/area/rogue)
"p" = (/mob/living/simple_animal/hostile/megafauna/dragon,/turf/open/floor/rogue/naturalstone,/area/rogue)
"w" = (/turf/closed/mineral/rogue/bedrock,/area/rogue)
"y" = (/turf/open/floor/rogue/blocks,/area/rogue)
"A" = (/obj/structure/table/church{dir = 1},/turf/open/floor/rogue/churchmarble,/area/rogue)
"D" = (/obj/structure/mineral_door/wood,/turf/open/floor/rogue/naturalstone,/area/rogue)
"F" = (/obj/structure/table/church,/obj/item/candle/skull/lit,/turf/open/floor/rogue/churchmarble,/area/rogue)
"G" = (/obj/effect/rune,/turf/open/floor/rogue/blocks,/area/rogue)
"L" = (/mob/living/simple_animal/hostile/retaliate/rogue/minotaur/axe,/turf/open/floor/rogue/naturalstone,/area/rogue)
"O" = (/obj/machinery/light/rogue/firebowl/church,/turf/open/floor/rogue/blocks,/area/rogue)
"Q" = (/obj/structure/mineral_door/wood,/obj/structure/roguewindow/stained/zizo,/turf/open/floor/rogue/blocks,/area/rogue)
"R" = (/obj/structure/roguewindow/stained/zizo,/turf/closed/wall/mineral/rogue/stonebrick,/area/rogue)
"S" = (/mob/living/simple_animal/hostile/retaliate/rogue/minotaur/axe/female,/turf/open/floor/rogue/naturalstone,/area/rogue)
"Z" = (/turf/open/lava,/area/rogue)

(1,1,1) = {"
wwwwwwwwwwwwwwwwwwwwwwwwwwwwwwwwwwwwwwwwwwwwwwwwwwwwwwwwwwwwwwwwwwwwwwwwwwwwwwwwwwwwwwwwwwwwwwwwwwwwwwwwwwwwwwwwwwwwwwwwwwwwwwwwwwwwwww
wZZZZZZZZZZZZZZZZZZZZZZZZZZZZZZZZZZZZZZZZZZZZZZZZZZZbbbbbbbbbbbbbbbbbRbbbbbbbbbbbbbbbbbbbbbZZZZZZZZZZZZZZZZZZZZZZZZZZZZZZZZZZZZZZZZZZZw
wZZZZZZZZZZZZZZZZZZZZZZZZZZZZZZZZZZZZZZZZZZZZZZZZZZZbyyybyyyybyyybOyFcAyObyyybyyyybybyyybybZZZZZZZZZZZZZZZZZZZZZZZZZZZZZZZZZZZZZZZZZZZw
wZZZZZZZZZZZZZZZZZZZZZZZZZZZZZZZZZZZZZZZZZZZZZZZZZZZbyyybyyyybybybyyyGyyybybybyyyybyRyyyRybZZZZZZZZZZZZZZZZZZZZZZZZZZZZZZZZZZZZZZZZZZZw
wZZZZZZZZZZZZZZZZZZZZZZZZZZZZZZZZZZZZZZZZZZZZZZZZZZabyyybyyyybybybyyyyyyybybybyyyybydyyydybZZZZZZZZZZZZZZZZZZZZZZZZZZZZZZZZZZZZZZZZZZZw
wZZZZZZZZZZZZZZZZZZZZZZZZZZZaaZZaaZZZZZZZZZZZZZZaaaabyyybyyyybybybyyyyyyybybybyyyybyRyyybybZZZZZZZZZZZZZZZZZZZZZZZZZZZZZZZZZZZZZZZZZZZw
wZZZZZZZZZZZZZZZZZZZZZZZZZZZaaaaaaaaaaaaaaZZZaZaaaaabRQRbbRbdbybybyyyyyyybybybyyyybybyyybybaZZZZaZZZZZZZZZZZZZZZZZZZZZZZZZZZZZZZZZZZZZw
wZZZZZZZZZZZZZZZZZZZaaaaaaaaaaaaaaaaaaaaaaaaaaaaaaaabyyyyyyyybybybOyyyyyObybybyyyybybyyybybaZaaaaaZZZZZZaZZZZaZZZZZZZZZZZZZZZZZZZZZZZZw
wZZZZZZZZZZZZZZZZZZZaaaaaaaaaaaaaaaaaaaaaaaaaaaaaaaabbbbbyybybybybbRbdbRbbybybyyyybybyyybybaaaaaaaZZZZZaaZZaaaaaZZZZZZZZZZZZZZZZZZZZZZw
wZZZZZZZZZZZZZZZZZZZaaaaaaaaaaaaaaaaaZaaaaaaaaaaaaaabyyybyybybybybyyyyyyybybybbbRdbybbbbbybaaaaaaaaZZZaaaaaaaaaaZaZZZZZZZZZZZZZZZZZZZZw
wZZZZZZZZZZZZZZZZZZZaaaZZaaaaaZZZZZZZZZZZZZZZZZZaaaabybybyybybybybyyyyyyyyybyyyyyyyyyybyyyDaaaaaaaaaZaaaaaaaaaaaaaZZZZZZZZZZZZZZZZZZZZw
wZZZZZZZZZZZZZZZZZZZZZZZZZZaaaaaZaZZZZZZZZZZZZZZaaaabybybyybybybbbbbbbbbbbbbybbyyybbbybybybaaaaaaaaaaaaaaaaaaaaaaaZZZZZZZZZZZZZZZZZZZZw
wZZZZZZZZZZZZZZZZZZZZaZZZZZaaaaaaaZZZZZZZZZZZZZZaaaabybybybbybyyyyyyyyyyyyyyyybyyyybyybybybaaaaaaaaaaaaaaaaaaaaaZZZZZZZZZZZZZZZZZZZZZZw
wZZZZZZZZZZZZZZZZZZZaaaZZZZZaaaaaaZZZZZZZZZZZZZZZaaabybybyybybbbbbbbbbbbbbbybybyyyybyybybybaaaaaaaaaaaaaaaaaaaaaaZZZZZZZZZZZZZZZZZZZZZw
wZZZZZZZZZZZZZZZZZZZaaZZZZZZaaaaaaZZZZZZZZZZZZZZZaaabybybbybyyyyyyyyyyyyyybybybbbbbbyybybybaaaaaaaaaaaaaaaaaaaaaZZZZZZZZZZZZZZZZZZZZZZw
wZZZZZZZZZZZZZZZZZZZaaaaZZZZZaaaaZZZZZZZZZZZZZZZZaaabybyyyyyyybybyyyyyyyyybybyyyyyyyyyyybybaaaaaaaaaaaaaaaaaaaaaZZZZZZZZZZZZZZZZZZZZZZw
wZZZZZZZZZZZZZZZZZZZaaaaaZZZZaaaaZZZZZZZZZZZZZZZZaaabybbbbbbbbbybbbbbbbbbbbybbbbbbbbbbbbbybaaaaaaaaaaaaaaaaaaaaaaZZZZZZZZZZZZZZZZZZZZZw
wZZZZZZZZZZZZZZZZZZZaaaaaZaaZZZaZZZZZZZZZZZZZZZZZaaabyyyyyyyyyyyyyyyyyyyyyyyyyyyyyyyyyyyyybaaaaaaaaaaaaaaaaaaaaaZZZZZZZZZZZZZZZZZZZZZZw
wZZZZZZZZZZZZZZZZZaaaaaaZZaaaZZZZZZZZZZZZZZZZZZZZaaabbbbbbbbbbbbbbbbbDbbbbbbbbbbbbbbbbbbbbbaaaaaaaaaaaaaaaaaaaaaaZZZZZZZZZZZZZZZZZZZZZw
wZZZZZZZZZZZZZZZZZaaaaZZZaaaaaZZaZZZZZZZZZZZZZZZZZZaaaaaaaaaaaaaaaaaaaaaaaaaaaaaaaaaaaaaaaaaaaaaaaaaaaaaaaaaaaaaaZZZZZZZZZZZZZZZZZZZZZw
wZZZZZZZZZZZZZZZZZaaaaaZaaaaaaaZaZZZZZZZZZZZZZZZZZZaaaaaaaaaaaaaaaaaaaaaaaaaaaaaaaaaaaaaaaaaaaaaaaaaaaaaaaaaaaaaaZZZZZZZZZZZZZZZZZZZZZw
wZZZZZZZZZZZZZZZZZaaaaaZaaaaaaaaaZZZZZZZZZZZZZZZZZZZZZZZZZZZZZaaaaaaaaaaaaaaaZZZZZZZZZZZZZZaaaaaaaaaaaaaaaaaaaaaZZZZZZZZZZZZZZZZZZZZZZw
wZZZZZZZZZZZZZZZZZaaaZZZaaaaaaaaaZZZZZZZZZZZZZZZZZZZZZZZZZZZZZaaaaaaaaaaaaaaaZZZZZZZZZZZZZZaaaaZaaaaaaaaaaaaaaaaZZZZZZZZZZZZZZZZZZZZZZw
wZZZZZZZZZZZZZZZZZaaaZZaaaaaaaaaaZZZZZZZZZZZZZZZZZZZZZZZZZZZZZZZaaaaaaaZZZZZaZZZZZZZZZZZZZZZaZZZaaaaZZaaaaaaaaaaaZZZZZZZZZZZZZZZZZZZZZw
wZZZZZZZZZZZZZZZZZaaaaZZaaaaaaaaaZZZZZZZZZZZZZZZZZZZZZZZZZZZZZZZZaaaaaZZZZZaaZZZZZZZZZZZZZZZZZaaaaZZZZaZaaaaaaaaaZZZZZZZZZZZZZZZZZZZZZw
wZZZZZZZZZZZZZZZZZaaaZZZaaaaaaaaaZaaZZZZZZZZZZZZZZZZZZZZZZZZZZZZZZaaaaZZZaaaZZZZZZZZZZZZZZZZZZaaaZZZZZZZZaaaaaaaaZZZZZZZZZaZZZZZZZZZZZw
wZZZZZZZZZZZZZZZZZZZZZZaaaaaaaaZaaaaaaZZZZZZZZZZZZZZZZZZZZZZZZZZZZaaaaaZZaaZZZZZZZZZZZZZZZZZZaaaaZZZZZZZZaaaaaaaaaZZZZZZaaaaZZZZZZZZZZw
wZZZZZZZZZZZZZZZZZZaaaaaaaaaZZZZaaZZaaaaaZZZaZZZaaaaaaaaaZZZZZZZZZaaaaaaaaaZZZZZZZZZZZZZZZZZZZZaZZZZZZZZZaaaaaaaaaaZZZaaaaaaaZZZZZZZZZw
wZZZZZZZZZZZZZZZZZZaaaaaaaaaaaZZZZZZaaaaaZZaaaaZZZaaaaaaaZZZZaZZZaaaaaaaaaZZZZZZZZZZZZZZZZZZZZZZZZZZZZZZZaaaaaaaaaaaaaaaaaaaaaZZZZZZZZw
wZZZZZZZZZZZZZZZZZZaaaaaaaaaaZZaaZaaaaaaaaaaaaaZZZaaaaZZZZZZZaZaaaaaaaaaaZZZZZZZZZZZZZZZZZZZZZZZZZZZZZZZZaaaaaaaaaaaaaaaaaaaaaaZZZZZZZw
wZZZZZZZZZZZZZZZZZaaaaaaaaaaaaaaaaaaaaaaaaaaaaaaZZaaaaaaaaaZZaaZaaaaaaaaaaZZZZZZZZZZZZZZZZZZZZZZZZZZZZZZZaaaaaaaaaaaaaaaaaaaaaaZZZZZZZw
wZZZZZZZZZZZZZZZaaaaaaaaaaaaaaaaaaaaaaaaaaaaaaaaZZZaaaaaaaaaZaaZZaaaaaaaaaZZZZZZZZZZZZZZZZZZZZZZZZZZZZZZZaaaaaaaaaaaaaaaaaaaaaaaZZZZZZw
wZZZZZZZZZZZZZZZaaaaaaaaaaaaaaaaaaaaaaaaaaaaaaaaaZZZaaaaaaaaaaaaaaaaaaaaaaaZZZZZZZZZZZZZZZZZZZZZZZZZZZZZZaaaaaaaSaaaaaaaaaSaaaaaaZZZZZw
wZZZZZZZZZZZZZZZaaaaaaaaaaaaaaaaaaaaaaZZaaaaaaaaaZZZaaaaaaaaaaaaaaaaaaaaaaaZZZZZZZZZZZZZZZZZZZZZZZZZZZZZZaaaaaaaaaaaaaaaaaaaaaaaaZZZZZw
wZZZZZZZZZZZZaaaaaaaaaaaaaaaaaaaaaaaZZZZZZaaaaaaaaaZZZaaaaaaaaaaaaaaapaaaaaaaZZZZZZZZZZZZZZZZZZZZZZZZZZZZZZaaaaaaaaaaaaaaaaaaaaaaaZZZZw
wZZZZZZZZZZZZaaaaaaaaLaaaaaaaaLaaaaaaaaZZZaaaaaaaaaaZZZaaaaaaaaaaaaaaaaaaaaaaZZZZZZZZZZZZZZZZZZZZZZZZZZZZZZaaaaaaaaaaaaaaaaaaaaaaaZZZZw
wZZZZZZZZZZZZZZZZaaaaaaaaaaaaaaaaaaaaZZZZZZaaaaaaaaaaaZZZaaaaaaaaaaaaaaaaaaaaZZZZZZZZZZZZZZZZZZZZZZZZZZZZZZaaaaaaaaaaaaaaaaaaaaaaaaZZZw
wZZZZZZZZZZZZZZZZaaaaaaaaaaaaaaaaaaaZZZZZZZZZZZZZZaaaZZZZZZaaaaaaaaaaaaaaaaaaZZZZZZZZZZZZZZZZZZZZZZZZZZZZZaaaaaaaaaaaSaaaaaaaaaaaaaaZZw
wZZZZZZZZZZZZZZZZaaaaaaaaaLaaaaaaaaaaZZZZZZZZZZZZZaZaaZZZZZZZaaaaaaaaaaaaaaaZZZZZZZZZZZZZZZZZZZZZZZZZZZZZZZaaaaaaaaaaaaaaaaaaaaaaaaaZZw
wZZZZZZZZZZZZZZZZaaaaaaaaaaaaaaaaaaaZZZZZZZZZZZZZZZZZZZZZZZZZZaaaaZZZZZaaaaaZZZZZZZZZZZZZZZZZZZZZZZZZZZZZZZaaaaaaaaaaaaaaaaaaaaaaaZZZZw
wZZZZZZZZZZZZZZZZaaaaaaaaaaaaaaaaaaaZZZZZZZZZZZZZZZZZZZZZZZZZZaaaaZZZZZaaaZaZZZZZZZZZZZZZZZZZZZZZZZZZZZZZZaaaaaaaaaaaaaaaaaaaaaaaZZZZZw
wZZZZZZZZZZZZZZZZaaaaaLaaaaaaaaLaaaaZZZZZZZZZZZZZZZZZZZZZZZZZZaZZZZZZZaaaaZZZZZZZZZZZZZZZZZZZZZaaaaaaZZZZZaaaaaaSaaaaaaaaaaSaaaaaZZZZZw
wZZZZZZZZZZZZZaaaaaaaaaaaaaaaaaaaaaaaZZZZZZZZZZZZZZZZZZZZZZZZZZZZZZaaaaaaaaZZZZZZZZZZZZZZZZZZZaaaaaaZZZZZZZaaaaaaaaaaaaaaaaaaaaaZZZZZZw
wZZZZZZZZZZZZZaaaaaaaaaaaaaaaaaaaaaaaZZZZZZZZZZZZZZZZZZZZZZZZZZaaZaaaaaaaaaaZZZZZZZZZZZZZZZZZaaaaaaaaZZZZZZZaaaaaaaaaaaaaaaaaaaZZZZZZZw
wZZZZZZZZZZZZZZaaaaaaaaaaaaaaaaaaaaaaZZZZZZZZZZZZZZZZZZZZZZZZZZaaaaaaaaaaaaaaZZZZZZZZZZZZZZZaaaaaaaaZZZZZaaZZaaaaaaaaaaaaaaaaaZZZZZZZZw
wZZZZZZZZZZZZZZZaaaaaaaaaaaaaaaaaaZZZZZZZZZZZZZZZZZZZZZZZZZZZZZaaaaaaaaaaaaaaZZZZZZZZZZZZaZaaaaaaaaZZaZZaaaaZZaaaaaaaaaaaaaaaaaZZZZZZZw
wZZZZZZZZZZZZZZaaaaaaaaaaaaaaaaaZZZZZZZZZZZZZZZZZZZZZZZZZZZZZZZaaaaaaaaaaaaaaZZZZZZZZZZZZaaaaaaaaaaaaaaaaaaaZZZaaaaaaaaaaaaaaZZZZZZZZZw
wZZZZZZZZZZZZZZZZaaaaaaaaaaaaaaZZZZZZZZZZZZZZZZZZZZZZZZZZZZZZZZZaaaaaaaaaZZZaZZZZZZZZZZZZZZaaaaaaaaaaaaaaaaaaZZaaaaaaaaaaaaaZZZZZZZZZZw
wZZZZZZZZZaaaaZZZZaaaaaaaaaaaaZZZZZZZZZZZZZZZZZZZZZZZZZZZZZZZZZZaaaaaaaaZZZZZZZZZZZZZZZZZZaaaaaaaaaaaaaaaaaaaaZZaaaaaaaaaaaaZZZZZZZZZZw
wZZZZZZZZZaaaaaZZaaaaaaaaaaaaaZZZZZZZZZZZZZZZZZZZZZZZZZZZZZZZZZZaaaaaaaaaZZZZZZZZZZZZZZZZZaaaaaaaaaaaaaaaaaaaaaZaaaaaaaaaaaZZZZZZZZZZZw
wZZZZZZZZZaaaaaZZZZaaaaaaaaaaaZZZZZZZaZZZZZZZZZZZZZZZZZZZZZZZZZZaaaaaaaaaZZZZZZZZZZZZZZZZaaaaaaaaaaaaaaaaaaaaaaZZaaaaaaaaaaZZZZZZZZZZZw
wZZZZZZZZaaaaaaaZZZaaaaaaaaaaaZZaaaaaZZZZZZZZZZZZZZZZZZZZZZZZZZZaaaaaaaaaaZZZZZZZZZZZZZZZaaaaaaaaaaaaaaaaaaaaaaZZaaaaaaaaaaZZZZZZZZZZZw
wZZZZZZZZaaaaaaaaZZZaaaaaaaaaaZZaaaaaaaaZZZZZZZZZZZZZZZZZZZZZZZZaaaaaaaaaaaZZZZZZZZZZZZZZaaaaaaaaaaaaaaaaaaaaaZZZZaaaaaaaaaZZZZZaaZZZZw
wZZZZZZZaaaaaaaaaaaZaaaaaaaaaZZaaaaaaaaZaZZZZZZZZZZZZZZZZZZZZZZZaaaaaaaaaaaZZZZZZZZZZZZZZaaaaaaaaaaaaaaaaaaaaaaZZZaaaaaaaaaZaZaaaaaZZZw
wZZZZZZZaaaaaaaaaaaaaaaaaaaaaaaaaaaaaaaaaaZZZZZZZZZZZZZZZZZZZZZZZaaaaaaaaaaaaZZZZZZZZZZZZaaaaaaaaaaaaaaaaaaaaaZZZZaaaaaaaaaaaaaaaaaaZZw
wZZZZZZZaaaaaaaaaaaaaaaaaaaaaaaaaaaaaaaaaZZZZZZZZZZZZZZZZZZZZZZZZaaaaaaaaaaaaZZZZZZZZZZZZaaaaaaaaaaaaaaaaaaaaaaZZZaaaaaaaaaaaaaaaaaaZZw
wZZZZZZZZaaaaaaaaaaaaaaaaaaaaaaaaaaaaaaaaaaZZZZZZZZZZZZZZZZZZZZZZaaaaaaaaaaaaZZZZZZZZZZZZZaaaaaaaaaaaaaaaaaaaaaZZZZaaaaaaaaaaaaaaaaaZZw
wZZZZZZZZZaaaaaaaaaaaaaaaaaaaaaaaaaaaaaaaaaZZZZZZZZZZZZZZZZZZZZZaaaaaaaaaaaaaZZZZZZZZZZZZZZaZaZaaaaaaaaaaaaaaaaZZZZaaaaaaaaaaaaaaaaaZZw
wZZZZZZZZZaaaaaaaaaaZaaaaaaaaaaaaaaaaaaaaaaZZZZZZZZZZZZZZZZZZZZZaaaaaaaaaaaZaZZZZZZZZZZZZZZaZZZaaaaaaaaaaaaaaaZZZaaaaaaaaaaaaaaaaaaaZZw
wZZZZZZZZZaaaaaaaaaaZaaaaaaaaaaaaaaaaaaaaaaZZZZZZZZZZZZZZZZZZZZZZZaaaaaaaaaZZZZZZZZZZZZZZZZZZZZZZaaaaaaaaaaaaZZZZaaaaaaaaaaaaaaaaaaaZZw
wZZZZZZZZZZaaaaaaaaaZaaaaaaaaaaaaaaaaaaaaaaZZZZZZZZZZZZZZZZZZZZZZZaaaaaaaaaaZZZZZZZZZZZZZZZZZZZZZZZZZZaaaaaaaaaZZZaaaaaaaaaaaaaaaaaZZZw
wZZZZZZZaaZZaaaaaaaaZaaaaaaaaaaaaaaaaaaaaaZZZZZZZZZZZZZZZZZZZZZZZZaaaaaaaaaaZZZZZZZZZZZZZZZZZZZZZZZZZZZaaaaaaaaaZZaaaaaaaaaaaaaaaaZZZZw
wZZZZZZZZaaZaaaaaaaZZaaaaaaaaaaaaaaaaaaaaaZZZZZZZZZZZZZZZZZZZZZZZZaaaaaaaaaaZZZZZZZZZZZZZZZZZZZZZZZZZZZaaaaaaaaaaZaaaaaaaaaaaaaaaZZZZZw
wZZZZZZZaaaZZaaaaaZZZaaaaaaaaaaaaaaaaaaaaaZZZZZZZZZZZZZZZZZZZZZZZZZaaaaaaaaaZZZZZZZZZZZZZZZZZZZZZZZZZaaaaaaaaaaaaZZaaaaaaaaaaaaaaZZZZZw
wZZZZZZZaaaZZaaaaaZZZaaaaaaaaaaaaaaaaaaaaZZZZZZZZZZZZZZZZZZZZZZZZZZaaaaaaaaZZZZZZZZZZZZZZZZZZZZZZZZZZZZaaaaaaaaaaaZZaaaaaaaaaaaaZZZZZZw
wZZZZZZZaaaaZaaaaZZZZaaaaaaaaaaaaaaaaaaaZZZZZZZZZZZZZZZZZZZZZZZZZZZaaaaaaaaZZZZZZZZZZZZZZZZZZZZZZZZZZZZZaaaaaaaaaaZZZaaaaaaaaaaZZZZZZZw
wZZZZZZZZZZZZZZZZZZZZZaaaaaaaaaaaaaaaaaaZZZZZZZZZZZZZZZZZZZZZZZZZZZZaaaaaaaZZZZZZZZZZZZZZZZZZZZZZZaaaaaZZaaaaaaaaaaZZZaaaaaaaaZZZZZZZZw
wZZZZZZZZZZZZZZZZZZZZZZZaaaaaaaaaaaaaaaZZZZZZZZZZZZZZZZZZZZZZZZZZZZZaaaaaaaaZZZZZZZZZZZZZZZZZZZaaaaaaaZZZZaaaaaaaaaaZZaaaaaaaZZZZZZZZZw
wZZZZZZZZZZZZZZZZZZZZZZZaaaaaaaaaaaaaaaZZZZZZZZZZZZZZZZZZZZZZZZZZZZZaaaaaaaZZZZZZZZZZZZZZZZZZZZaaaaaaaZZZZZaaaaaaaaaaZZaaaaaaZZZZZZZZZw
wZZZZZZZZZZZZZZZZZZZZZZaaaaaaaaaaaaaaaZZZZZZZZZZZaZZZZZZZZZZZZZZZZZZaaaaaaZZZZZZZZZZZZZZZZZZaZZaaaaaaZZZaZZZaaaaaaaaaaZZaaaaaZZZZZZZZZw
wZZZZZZZZZZZZZZZZZZZZZZZaaaaaaaaaaaaaaZZZZZZZZZZZaaZZZZZZZZZZZZZZZZZaaaaaaZZZZZZZZZZZZZZZZZaaZZaaaaaaaZaaZZZZaaaaaaaaaaZZaaaaZZZZZZZZZw
wZZZZZZZZZZZZZZZZZZZZZZZaaaaaaaaaaaaaZZZZaZZZZZZaaaZZZZZZZZZZZZZZZZZaaaaaaaZZZZZZZZZZZZZZZZaaaaaaaaaZZZaaaaaaaaaaaaaaaaZZaaaaZZZZZZZZZw
wZZZZZZZZZZZZZZZZZZZZZZaaaaaaaaaaaaaaZZZZaZZZZZZaaaaZZZZZZZZZZZZZZZaaaaaaaZZZZZZZZZZZZZZZZZaaaaaaaaZZZaaaaaaaaaaaaaaaaaaZZaaaZZZZZZZZZw
wZZZZZZZZZZZZZZZZZZZZZaaaaaaaaaaaaaaZZZZaaZZZZZZaaaaZZZZZZZZZZZZZaaaaaaaaZZaZZZZZZZZZZZZZZZaaaaaaaaZZZaaaaaaaaaaaaaaaaaaaZZaaZZZZZZZZZw
wZZZZZZZZZZZZZZZZZZZZZZaaaaaaaaZZaaZZZZZaaZZZZZZaaaaZZZZZZZZZZZZZaaaaaaZZaZaaZZZZZZZZZZZZZZaaaaaaaZZZaaaaaaaaaaaaaaaaaaaaaZZZZZZZZZZZZw
wZZZZZZZZZZZZZZZZZZZZZaaaaaaaaaZaZaZZZZaaaZZZZZZaaaaZZZZZZZZZZZaaaaaaaaaaaaaaZZZZZZZZZZZZaaaaaaaaaZZZaaaaaaaaaaaaaaaaaaaaaaZZZZZZZZZZZw
wZZZZZZZZZZZZZZZZZZZZaaaaaaaaaaaaZZZZZaaaaaZZZZZZaaaaZZZZZZZZZZaaaaaaaaaaaaaZZZZZZZZZZZZZaaaaaaaaaZZaaaaaaaaaaaaaaaaaaaaaaaaZZZZZZZZZZw
wZZZZZZZZZZZZZZZZZZZZZaaaaaaaaaaZZZZZZZaaaaaaaaaaaZaaZZZZZZZZZZaaaaaaaaaaaaaZZZZZZZZZZZZZaaaaaaaaaZZaaaaaaaaaaaaaaaaaaaaaaaaaZZZZZZZZZw
wZZZZZZZZZZZZZZZZZZZZZaaaaaaaaaaaZZZZZaaaaaaaaaaaaaaaZZZZZZZZZaaaaaaaaaaaaaZZZZZZZZZZZZZZaaaaaaaaaZaaaaaaaaaaaaaaaaaaaaaaaaaaZZZZZZZZZw
wZZZZZZZZZZZZZZZZZZZZZZZaaaaaaaaaZZZZZZZZaaaaaaaaZaaaZZZZZZZZZaaaaaaaaaaaaZZZZZZZZZZZZZZZaaaaaaaaZZaaaaaaaaaaaaaaaaaaaaaaaaaaZZZZZZZZZw
wZZZZZZZZZZZZZZZZZZZZZaZaaaaaaaaaZZZZZZZZaaaaaaaaaaaaaZZZZZZZZaaaaaaaaaaaaZZZZZZZZZZZZZZZaaaaaaaaaaaaaaaaaaaaaaaaaaaaaaaaaZZZZZZZZZZZZw
wZZZZZZZZZZZZZZZZZZZZZaaaaaaaaaaZZZZZZZZZaaaaaaaaaaaaaZZZZZZZZaaaaaaaaaaaZZZZZZZZZZZZZZZZZZaaaaaaaaaaaaaaaaaaaaaaaaaZZaaZZZZZZZZZZZZZZw
wZZZZZZZZZZZZZZZZZZZZZZaaaaaaaaaaZZZZZZZZZaaaaaaaaaaaaZZZZZZZZaaaaaaaaaaaZZZZZZZZZZZZZZZZZZaaaaaaaaaaaaaaaaaaaaaaaaaZZZZZZZZZZZZZZZZZZw
wZZZZZZZZZZZZZZZZZZZZZZZaaaaaaaaaaaZZZZZZZaaaaaaZaaaaZZZZZZZZZaaaaaaaaaaaZZZZZZZZZZZZZZZZZZaaaaaaaaaaaaaaaaaaaaaaaaZZZZZZZZZaZZZZZZZZZw
wZZZZZZZZZZZZZZZZZZZZZZaaaaaaaaaaaaZZZZZZZaaaaaaZaaaZZZZZZZZZZZaaaaaaaaaaZZZZZZZZZZZZZZZZZZaaaaaaaaaaaaaaaaaaaaaaaaaZZZZZZaaaZZZZZZZZZw
wZZZZZZZZZZZZZZZZZZZaaZaaaaaaaaaaaaZZZZZZZaaaaaaZaaaZZZZZZZZZZZaaaaaaaaaZZZZZZZZZZZZZZZZZZaaaaaaaaaaaaaaaaaaaaaaaaaaZZZZZaaaaZZZZZZZZZw
wZZZZZZZZZZZZZZZZZZaaaaaaaaaaaaaaaaZZZZZZZaaaaaaZaaZZZZZZZZZZZZaaaaaaaaaZZZZZZZZZZZZZZZZZZaaaaaaaaaaaaaaaaaaaaaaaaaaaZZZaaaaaZZZZZZZZZw
wZZZZZZZZZZZZZZZZZZaaaaZaaaaaaaaaaaZZZZZZZaaaaaaaaaZZZZZZZZZZZZaaaaaaaaZZZZZZZZZZZZZZZZZZZZaaaaaaaaaaaaaaaaaaaaaaaaaaaZaaaaaaZZZZZZZZZw
wZZZZZZZZZZZZZZZZZZaaaaZaaaaaaaaaaaZZZZZZZZaaaaaaaZZZZZZZZZZZZZaaaaaaaaaaZZZZZZZZZZZZZZZZZZZaaaaaaaaaaaaaaaaaaaaaaaaaaaaaaaaaZZZZZZZZZw
wZZZZZZZZZZZZZZZZZZaaaaaaaaaaaZZaaaaZZZZZZZaaaaaaaZZZZZZZZZZZZZaaaaaaaaaaaZZZZZZZZZZZZZZZZaaaaaaaaaaaaaZaZaaaaaaaaaaaaaaaaaaaZZZZZZZZZw
wZZZZZZZZZZZZZZZZZZaaaaaaaaaaaaZZZaaZZZZZZZaaaaaZZZZZZZZZZZZZZZZaaaaaaaaaaZZZZZZZZZZZZZZZaaaaaaaaaaaaaZZZaaaaaaaaaaaaaaaaaaaaZZZZZZZZZw
wZZZZZZZZZZZZZZaaaaaaaaaaaaaaaaZZZZZZZZZZZZaaaaaZZZZZZZZZZZZZZZZaaaaaaaaaaZZZZZZZZZZZZZZZaaaaaaaaaaaaaZZZZaaaaaaaaaaaaaaaaaaaZZZZZZZZZw
wZZZZZZZZZZZZZaaaaaaaaaaaaaaaaaaZZZZZZZZZZZZZaaaZZZZZZZZZZZZZZZZaaaaaaaaaaaZZZZZZZZZZZZZZaaaaaaaaaaaaaaZZZaaaaaaaaaaaaZaaaaaaZZZZZZZZZw
wZZZZZZZZZZZZZaaaaaaaaaaaaaaaaaaaZZZZZZZZZZZZaaaZZZZZZZZZZZZZZZZZaaaaaaaaaZZZZZZZZZZZZZZZaaaaaaaaaaaaaaZZZaaaaaaaaaZaaZaaaaaaZZZZZZZZZw
wZZZZZZZZZZZZaaaaaaaaaaaaaaaaaaaaZZZZZZZZZZZZZaaZZZZZZZZZZZZZZZZaaaaaaaaaaZaaZZZZZZZZZZZZaaaaaaaaaaaaaZZaaaaaaaaaaZZZZZaaaaaaZZZZZZZZZw
wZZZZZZZZZZZZaaaaaaaaaaaaaaaaaaaaaZZZZZZZZZZZZaaZZZZZZZZZZZZZZZZaaaaaaaaZZaaaaaaaaaaaaaaaaaaaaaaaaaaaZZaaaaaaaaaZZZZZZaaaaaaaZZZZZZZZZw
wZZZZZZZZZZZZaaaaaaaaaaaaaaaaaaaaaaZZZZZZZZZZZZZZZZZZZZZZZZZZZZZaaaaaaaaZZaaaaaaaaaaaaaaaaaaaaaaaaaaaaaaaaaaaaaaZZZZZaaaaaaaaZZZZZZZZZw
wZZZZZZZZZZZZZaaaaaaaaaaaaaaaaaaaaaaZZZZZZZZZZZZZZZZZZZZZZZZZZZaaaaaaaaaaaaaaaaaaaaaaaaaaaaaaaaaaaaaaaaaaaaaaaaaaaZZZaaaaaaaaZZZZZZZZZw
wZZZZZZZZZZZZaaaaaaaaaaaaaaaaaaaaaaaZZZZZZZZZZZZZZZZZZZZZZZZZZZaaaaaaaaaaaaaaaaaaaaaaaaaaaaaaaaaaaaaaaaaaaaaaaaaaaZZaaaaaaaaaaZZZZZZZZw
wZZZZZZZZZZZaaaaaaaaaaaaaaaaaaaaaaaaaaaZZZZZZZZZZZZZZZZZZZZZZZZaaaaaaaaaaaaaaaaaaaaaaaaaaaaaaaaaaaaaaaaaaaaaaaaaaaZaaaaaaaaaaaZZZZZZZZw
wZZZZZZZZZZaaaaaaaaaaaaaaaaaaaaaaaaaaaZZZZZZZZZZZZZZZZZZZZZZZZZaaaaaaaaaaaaaaaaaaaaaaaaaaaaaaaaaaaaaaaaaaaaaaaaaaaaaaaaaaaaaaaZZZZZZZZw
wZZZZZZZZZZaaaaaaaaaaaaaZZaaaaaaaaaaaaZZZZZZZZZZZZZZZZZZZZZZZZZaaaaaaaaaaaaaaaaaaaaaaaaZaaaaaaaaaaaaaaaaaaaaaaaaaaaaaaaaaaaaaaZZZZZZZZw
wZZZZZZZZZZaaaaaaaaaaaaaaZZaaaaaaaaaaZZZZZZZZZZZZZZZZZZZZZZZZZZaaaaaaaaaaaaaaaaaaaaaaaZZZaaaaaaaaaaaaaaaaaaaaaaaaaaaaaaaaaaaaaaZZZZZZZw
wZZZZZZZZZaaaaaaaaaaaaaaaaZZZZZZZaaZZZZZZZZZZZZZZZZZZZZZZZZZZZZaaaaaaaaaaaaaaaaaaaaaaZZZZaaaaaaaaaaaaaaaaaaaaaaaaZaaaaaaaaaaaaaZZZZZZZw
wZZZZZZZZZaaaaaaaaaaaaaaaZZZZZZZZZZZZZZZZZZZZZZZZZZZZZZZZZZZZZZZZaaaaaaaaaaaaaaaaaaaZZZZZaaaaaaaaaaaaaaaaaaaaaaaaZaaaaaaaaaaaZZZZZZZZZw
wZZZZZZZZaaaaaaaaaaaaaaaaaZZZZZZZZZZZZZZZZZZZZZZZZZZZZZZZZZZZZZZZaaaaaaaaaaaaaaaZZaZZZZZZaaaaaaaaaaaaaaaaaaaaaaaZZaaaaaaaaaaZZZZZZZZZZw
wZZZZZZZZaaaaaaaaaaaaaaaaZZZZZZZZZZZZZZZZZZZZZZZZZZZZZZZZZZZZZZZZaaaaaaaaaaaaaaZZZZZZZZZaaaaaaaaaaaaaaaaaaaaaaaaZZZaaaaaaaaaaaZZZZZZZZw
wZZZZZZZZaaaaaaaaaaaaaaaaaaZZZZZZZZZZZZZZZZZZZZZZZZZZaaZZZZZZZZZZaaaaaaaaaaaaaZZZZZZZZZZaaaaaaaaaaaaaaaaaaaaaaaaZZZaaaaaaaaaaaaZZZZZZZw
wZZZZZZZZaaaaaaaaaaaaaaaaaaaaaaaaaaZZZZaaZZZZZZZZZZZaaaaaZZZZZZZZaaaaaaaaZaaaaZZZZZZZZZZZaaaaaaaaaaZaaaaaaaaaaaZZZZaaaaZZaaaaaaZZZZZZZw
wZZZZZZZZaaaaaaaaaaaaaaaaaaaaaaaaaZZaaaaZaaaaZZZZZaaaaaaaZZZZZZaaaaaaaaaaZaaaZaZZZZZaZZZZZaaaaaaaaaZaaaaaaaaaaaZZZaaZZZZZaaaaaaZZZZZZZw
wZZZZZZZZaaaaaaaaaaaaaaaaaaaaaaaaZZaaaaaaaaaaZaaaaaaaaaaaZZZZZZaaZZaaaaaZZZaaaaZZZZZaZZaZZaaaaaaaaZZaaaaaaaaZZZZZZZZZZZZZZZaaaaZZZZZZZw
wZZZZZZZZaaaaaaaaaaaaaaaaaaaaaaaZZZaaaaaaaaaZaaaaaaaaaaaaaaaZZaaaaZaaaaaZZZaaaaaaaaaaZZZZZaaaaaaaZZZZaaaaaaaZZZZZZZZZZZZZZZaaaaZZZZZZZw
wZZZZZZZZaaaaaaaaaaaaaaaaaaaaaaaaaZZaaaaaaaZaaaaaaaaaaaaaaaaaaaaaaaaaaaZZZZZaaaaaaaaaaaZaaaaaaaaaZZZZZaaaaaaZZZZZZZZZZZZZZZaZZaZZZZZZZw
wZZZZZZZZaaaaaaaaaaaaaaaaaaaaaaaaaaaaaaaaaZZaaaaaaaaaaaaaaaaaaaaaaaaaaaZZZaaZaaaaaaaaaaaaaaaaaaaaZZZZZaaaaaaZZZZZZZZZZZZaZZZZZZZZZZZZZw
wZZZZZZZZaaaaaaaaaaaaaaaaaaaaaaaaaaaaaaaaaaaaaaaaaaaaaaaaaaaaaaaaaaaaaaaaaaaaaaaaaaaaaaaaaaaaaaaaZZZZZaaaaaaZZZZZZZZZZZZaZZZaaZZZZZZZZw
wZZZZZZZZaaaaaaaaaaaaaaaaaaaaaaaaaaaaaaaaaaaaaaaaaZaaaaaaaaaaaaaaaaaaaaaaaaaaaaaaaaaaaaaaaaaaaaaZaaZZZaaaaaaZZZZZZZZZaaaaaaaaaaaZZZZZZw
wZZZZZZZZZaaaaaaaaaaaaaaaaaaaaaaaaaaZZaaaaaaaaaaaaaZaaaaaaaaaaaaaaaaaaaaaaaaaaaaaaaaaaaaaaaaaaaZZaZZZZaaaaaaZZZZZZZZZaaaaaaaaaaaZZZZZZw
wZZZZZZZZZaaaaaaaaaaaaaaaaaaaaaaaaaZZZZaZZZZZaaaZZZZZaaaaaaaaaaaaaaaaaaaaaaaaaaaaaaaaaaaaaaaaaaZaaZZZZaaaaaZZZZZZZZZZaaaaaaaaaaZZZZZZZw
wZZZZZZZZZZaaaaaaaaaaaaaaaaaaaaaaaZZZZZZZZZZZZZZZZZZZZZZaaaaaaaaaaaaaaaaaaaaaaaaaZZaaaaaaaaZZaaaaaZZZZZZaaZZZZZZZZZZZaaaaaaaaaZZZZZZZZw
wZZZZZZZZZZaaaaaaaaaaaaaaaaaaaZZZZZZZZZZZZZZZZZZZZZZZZZZaaaaaaaaaaaaaaaaaaaaaaaaaZZZZaaaaZZZZZaaaZZZZZZZZaZZZZZZZZZZZZaaaaaaaaZZZZZZZZw
wZZZZZZZZZZaaaaaaaaaaaaaaaaaaZZZZZZZZZZZZZZZZZZZZZZZZaaaZaaaaaaaaaaaaaaaaaaaaaaaaaZZZZZZZZZZZZZZZZZZZZZZZZZZZZZZZZZZZaaaaaaaaZZZZZZZZZw
wZZZZZZZZZZZaaaaaaaaaaaaaaaZZZZZZZZZZZZZZZZZZZZZZZZZZaaaaaaaaaaaaaaaaaaaaaaaaaaaaaaZZZZZZZZZZZZZZZZZZZZZZZZZZZZZZZZZZZZZaaaaaZZZZZZZZZw
wZZZZZZZZZZZZZaaaaaaaaaaaaZZZZZZZZZZZZZZZZZZZZZZZZZZZaaaaaaaaaaaaaaaaaaaaaaaaaaaaaaZZZZZZZZZZZZZZZZZZZZZZZZZZZZZZZZZZZZZZZZZZZZZZZZZZZw
wZZZZZZZZZZZZZZZaaaaaaaaZZZZZZZZZZZZZZZZZZZZZZZZZZZZZaaaaaaaaaaaaaaaaaaaaaaaaaaaaaaaZZZZZZZZZZZZZZZZZZZZZZZZZZZZZZZZZZZZZZZZZZZZZZZZZZw
wZZZZZZZZZZZZZZZaaaaaaaZZZZZZZZZZZZZZZZZZZZZZZZZZZZZZaaaaaaaaaaaaaaaaaaaaaaaaaaaaaaaZZZZZZZZZZZZZZZZZZZZZZZZZZZZZZZZZZZZZZZZZZZZZZZZZZw
wZZZZZZZZZZZZZZZZZZZZZZZZZZZZZZZZZZZZZZZZZZZZZZZZZZZZaaaaaaaaaaaaaaaaaaaaaaaaaaaaaaaZZZZZZZZZZZZZZZZZZZZZZZZZZZZZZZZZZZZZZZZZZZZZZZZZZw
wZZZZZZZZZZZZZZZZZZZZZZZZZZZZZZZZZZZZZZZZZZZZZZZZZZZZaaaaaaaaaaaaaaaaaaaaaaaaaaaaaaaZZZZZZZZZZZZZZZZZZZZZZZZZZZZZZZZZZZZZZZZZZZZZZZZZZw
wwwwwwwwwwwwwwwwwwwwwwwwwwwwwwwwwwwwwwwwwwwwwwwwwwwwwwwwwwwwwwwwwwwwwwwwwwwwwwwwwwwwwwwwwwwwwwwwwwwwwwwwwwwwwwwwwwwwwwwwwwwwwwwwwwwwwww
"}
